1111111111111111111
1P00000100000000001
1011110101101111101
1001C10000101C1C101
1101011110100010101
1001010000101110101
1011011C10101010001
1010001110101011111
10001000001000000E1
1111111111111111111