11111111111
10000000001
10111011101
1P1C000C1E1
11111111111