1111111111111
100000C000001
1000111110001
10000P1E00001
1111111111111