11111111111
1P000C000E1
100M000M001
11111111111