11111111111
1P000C000E1
10000M00001
11111111111