1111111111
1E00P000E1
1111111111