111111111111111111111
1P00000000000000000E1
100011111100011111001
10001C000100000000001
100011111100011111001
111111111111111111111
